  WWWWW
  W E W
WWW   WWW
WTTTTTTTW
WT TTT TW
WT TTT TW
WT TTT TW
WTTTTTTTW
W   S   W
WWWWWWWWW