 WWWWWWWWWWWWWWWWWWW 
WTW     W  WTW      W
W   E   L           W
WTW     W  TTT      W
 WWWWWWWWWWWTWWWW   W
WTT     W    TTTW   W
WT      W     TTW   W
 WWWWWWUWUWWWWWWW   W
W       W   W  TW   W
W       U   W  TW   W
W       W   W  TW   W
W   WWWWW   W  WT   W
W   W K W   W   W   W
W   W   W   W   W   W
W   WWUWW   W   W   W
W   W       WW  W   W
W   W           W   W
W   W           W   W
W   W    WWWWWWWW   W
W S W               W
W   W               W
 WWW WWWWWWWWTWWWWWW 
             W       